{
  "values": [
    [
      1774,1775,1991,1992,1993,1994,1999,2001,2002,2004,2005,2006,2007,2008,2009,2010,2011,2012,2014,2015,2016,2017,2018,2475,2485,2486,2512,2513,2518,2519,2520,2521,2536,2537,2542,2543,2544,2545,2546,2547,2548,2549,2550,2551,2552,2553,2554,2555,2559,2560,2561,2562,2563,2564,2565,2566,2567,2568,2569,2570,2571
    ],
    [
      1774,1775,1991,1992,1993,1994,1999,2000,2001,2002,2003,2004,2005,2006,2007,2008,2009,2010,2011,2012,2014,2015,2016,2017,2018,2475,2483,2484,2485,2486,2512,2513,2518,2519,2520,2521,2535,2536,2537,2542,2543,2544,2545,2546,2547,2548,2549,2550,2551,2552,2553,2554,2555,2559,2560,2561,2562,2563,2564,2565,2566,2567,2568,2569,2570,2571
    ],
    [
      1774,1775,1991,1992,1993,1994,1999,2001,2002,2004,2005,2006,2007,2008,2009,2010,2011,2012,2014,2015,2016,2017,2018,2475,2483,2484,2485,2486,2512,2513,2518,2519,2520,2521,2535,2536,2537,2542,2543,2544,2545,2546,2547,2548,2549,2550,2551,2552,2553,2554,2555,2559,2560,2561,2562,2563,2564,2565,2566,2567,2568,2569,2570,2571
    ],
    [
      1774,1775,1991,1992,1993,1994,1999,2000,2001,2002,2003,2004,2005,2006,2007,2008,2009,2010,2011,2012,2014,2015,2016,2017,2018,2542,2543,2545,2546,2547,2548,2549,2550,2552,2553,2554,2555,2559,2560,2561,2562,2563,2564,2565,2566,2567,2568,2569,2570,2571
    ],
    [
      1774,1775,1991,1992,1993,1994,1999,2000,2001,2002,2003,2004,2005,2006,2007,2008,2009,2010,2011,2012,2014,2015,2016,2017,2018,2475,2483,2484,2485,2486,2512,2513,2518,2519,2520,2521,2536,2537,2542,2543,2544,2545,2546,2547,2548,2549,2550,2551,2552,2553,2554,2555,2559,2560,2561,2562,2563,2564,2565,2566,2567,2568,2569,2570,2571
    ],
    [
      1774,1775,1991,1992,1993,1994,1999,2000,2001,2002,2003,2004,2005,2006,2007,2008,2009,2010,2011,2012,2014,2015,2016,2017,2018,2542,2545,2548,2550,2552,2553,2554,2555,2559,2560,2561,2562,2563,2564,2565,2566,2567,2568,2569,2570,2571
    ],
    [
      1774,1775,1991,1992,1993,1994,1999,2000,2001,2002,2003,2004,2005,2006,2007,2008,2011,2014,2015,2016,2017,2018,2542,2545,2548,2550,2552,2553,2554,2555,2559,2560,2561,2562,2563,2564,2565,2566,2567,2568,2569,2570,2571
    ],
    [
      1774,1775,1991,1992,1993,1994,1999,2000,2001,2002,2003,2004,2005,2006,2007,2008,2014,2015,2016,2017,2018,2542,2545,2548,2550,2552,2553,2554,2555,2559,2560,2561,2562,2563,2564,2565,2566,2567,2568,2569,2570,2571
    ],
    [
      1774,1775,1988,1990,1991,1992,1993,1994,1998,1999,2000,2001,2002,2003,2004,2005,2006,2007,2008,2014,2015,2016,2017,2018,2542,2545,2548,2550,2552,2553,2554,2555,2559,2560,2561,2562,2563,2564,2565,2566,2567,2568,2569,2570,2571
    ],
    [
      1774,1775,1991,1992,1993,1994,1999,2000,2001,2002,2003,2004,2005,2006,2007,2008,2014,2015,2016,2017,2018,2542,2545,2548,2550,2552,2553,2554,2555,2559,2560,2561,2562,2563,2564,2565,2566,2567,2568,2569,2570,2571
    ],
    [
      1774,1775,1991,1992,1993,1994,1998,1999,2000,2001,2002,2003,2004,2005,2006,2007,2008,2014,2015,2016,2017,2018,2542,2545,2548,2550,2552,2553,2554,2555,2559,2560,2561,2562,2563,2564,2565,2566,2567,2568,2569,2570,2571
    ],
    [
      1774,1775,1991,1992,1993,1994,1999,2000,2001,2002,2003,2004,2005,2006,2007,2008,2014,2015,2016,2017,2018,2542,2545,2548,2550,2552,2553,2554,2555,2559,2560,2561,2562,2563,2564,2565,2566,2567,2568,2569,2570,2571
    ]
  ]
}